#######
#$    #
#$    #
#     #
#  ...#
#######