#####
#   #
# $ #
#   #
#.  #
#####