#####
#   #
#$  #
#   #
#.  #
#####