#######
#     #
# $   #
#   $ #
#  .. #
#######