#######
#$ .  #
#     #
#     #
#######