#####
#$  #
#$  #
#   #
# ..#
#####
