#######
#$$   #
#     #
#  .. #"
#######
