#######
#######
#  $  #
#######
#  .  #
#######
