#######
#     #
#.$$$##
#  $  #
#     #
#######
