#######
#     #
# $$  #
# $$  #
#     #
# ....#
#######