#####
## ##
## ##
#$ ##
## ##
#.  #
#####
