#########
#$$$     #
#        #
#   ...  #
#########
