########################
# . . . . . . . . . .  #
# $$$$$$$$$$$$$$$$$    #
#          @           #
########################