#####################
#   ###########     #
# . #         #     #
# $ ### ## #$ #     #
# $    ..     #     #
#     @       #     #
#####################