########################
#   ##############     #
# . #            #     #
# $ $$$ $$$ $$ $ #     #
# $$$   ...      #     #
#      @         #     #
########################