########
# . .  #
# $$   #
#  @   #
#   ####
########