####################
# . # .  . # .  .  #
# $$  $ $   $      #
#       @          #
####################