###########
#    .    #
# $  $    #
#   @     #
#    .    #
###########