###################
# . . . . . . .   #
#  $#$#$$#$$#$    #
#       @         #
###################