##############
#            #
# . #  #     #
# $ $$ #     #
#   @  #     #
# . .  #     #
##############