############
#    .     #
# $##$     #
#   @      #
#    .     #
############