####################
# . . . . . . . .  #
# $$$ $$$ $$$ $$   #
#        @         #
####################