#############
#     .     #
# $$$$$     #
#   @       #
#     .     #
#############