###################
#   #########     #
# .         #     #
# $ ## ## $ #     #
#      .    #     #
#    @      #     #
###################