################
# . . . . .    #
# $$$ $$$ $$   #
#      @       #
################