##########
#   .    #
# $$ $   #
#   @    #
#   .    #
##########