######################
# . . . . . . . . .  #
# $$$ $$$ $$$ $$$    #
#         @          #
######################