######################
# . . . . . . . . .  #
# #$$ $$$ $$$ $##    #
#         @          #
######################