##############
#     ####   #
# .$  #  #   #
#  $  .  #   #
#   @    #   #
##############