#########
#   .   #
# $$$   #
#   @   #
#   .   #
#########