########################
#   ##############     #
# . #            #     #
# $ ### ##$ #$ # #     #
# $     ...      #     #
#      @         #     #
########################