############
# . . . .  #
# $$$ $    #
#    @     #
############