###################
# . . . . . . .   #
#  $#$#$$#$$#$    #
#       @         #
#                 #
###################