###############
#             #
#   ######    #
#      . #    #
# $ $    #    #
#  $  .  #  . #
#   @    #    #
###############