################
#     ######   #
# .#$ #    #   #
#  $  # $# #   #
#  .  #  . #   #
#   @      #   #
################