###########
# . . .   #
# $$$     #
#    @    #
###########