##############
#     ####   #
# .$$ #  #   #
#  $$ .  #   #
#   @    #   #
##############