#########
# . .   #
# $$@   #
#       #
#########