#######################
# . . . . . . .  .    #
# ##$ $$# $$# $##$$   #
#        @            #
#######################