##################
#      ######    #
# .$#$ #    #    #
# $#   # $# #    #
#  ..  #  . #    #
#    @      #    #
##################