####################
#     #########    #
# .#$ #       #    #
# $$  # $# #$ #    #
#  .. #  ..   #    #
#    @        #    #
####################