##################
#      ######    #
# .$ $ #    #    #
# $#   # $# #    #
#  ..  #  . #    #
#    @      #    #
##################