############
# . . . .  #
# $$$ $$$  #
#    @     #
############