###############
# . . . . .   #
# $$$$$$$     #
#     @       #
###############