################
#   ######     #
# . #    #     #
# $ $$   #     #
#  $$ .  #     #
#   @    #     #
################