############
# .  .  .  #
# #$$ $#   #
#    @     #
############