##########################
#     ##############     #
# .$$ #            #     #
# $$$ # $$$ $$$ $$ #     #
#  .. #   ..       #     #
#      @           #     #
##########################