###############
# .   .   .   #
# $ # $ # $   #
#  ##   ###   #
# @ .   . $   #
#         $   #
###############