############
# .  .  .  #
# $$$ $$   #
#    @     #
############