############
#    .     #
# $$$$     #
#   @      #
#    .     #
############