#########
# . .   #
# $$@   #
#   .   #
#########