##########
# .   .  #
# $$ $$  #
#   @    #
##########