###############
#             #
#     ####    #
#      . #    #
# $#$    #    #
#  $  .     . #
#   @    #    #
###############