#############
#     .     #
# ###$$     #
#   @       #
#     .     #
#############