######
#  @ #
# $$ #
# .. #
######