############################
# . . . . . . . . . . . .  #
# $$$$$$$$$$$$$$$$$$$$$$$  #
#            @             #
############################