##########
#   .    #
# ###$   #
# @  .   #
#   $    #
##########