####################
# . # .  . # .  .  #
# $$# $ $   $      #
#       @          #
####################