################
#   ######     #
# . #    #     #
# $ #$   #     #
#     .  #     #
#   @    #     #
################