####################
#     #########    #
# .$$ #       #    #
# $$  # $$ $$ #    #
#  .. #  ..   #    #
#    @        #    #
####################