###########
# . . .   #
# $$$$$   #
#    @    #
###########