#############
# . #   .   #
# $ #   $   #
#   @       #
#############