#########
#   .   #
#  $$   #
#   @   #
#   .   #
#########