########
#  .   #
#  $   #
#  @   #
#  .   #
########