###############
#   ######    #
# . #    #    #
# $ $$   #    #
#  $$ .  #    #
#   @    #    #
###############