###########
#    .    #
# $$ $$   #
#   @     #
#    .    #
###########