########
#  .   #
#  $   #
# $$@. #
#  .   #
########