###############
# . . . . .   #
# $$#$$#$     #
#     @       #
###############