############
#  .   .   #
# $ #$     #
#   @      #
############