#########
# . . . #
# $$$   #
#   @   #
#########