#############
#   ####    #
# . #  #    #
# $ $$ #    #
#   @  #    #
# . .  #    #
#############