##############
# . . . .    #
# $$## #$$   #
#     @      #
##############