######
# .@ #
# $$ #
# .. #
######