#########################
# . . . . . . . . . . . #
# $$$$$$$$$$$$$$$$$$$   #
#           @           #
#########################