##########
# . . .  #
# $$$    #
#   @    #
##########