#######
#  .  #
#  $  #
# .$. #
#  @  #
#######