#################
#   #######     #
# . #     #     #
# $ $$ $$ #     #
#  $$  .  #     #
#    @    #     #
#################