#####################
# . . . . . . .     #
# ##$ $$# $$# $##$  #
#        @          #
#####################