##################
#      ######    #
# .$$$ #    #    #
# $$   # $$ #    #
#  ..  #  . #    #
#    @      #    #
##################