##########
# .  .   #
# $$ $$  #
#   @    #
##########