#######
#     #
#  $  #
# .$. #
#  @  #
#######