####################
#     #########    #
# .$$ #       #    #
# $#  # ## $# #    #
#  .. # $ ..  #    #
#    @        #    #
####################