################
#     ######   #
# .$$ #    #   #
# $$  # $$ #   #
#  .  #  . #   #
#   @      #   #
################