##############
#   ####     #
# . #  #     #
# $ $$ #     #
#   @  #     #
# . .  #     #
##############