#####################
#   ###########     #
# . #         #     #
# $ $$$ $$ $$ #     #
# $$   ..     #     #
#     @       #     #
#####################