#########
# .     #
# $##   #
#  @ .  #
#   $   #
#########