#############
#           #
# . #  #    #
# $ $$ #    #
#   @  #    #
# . .  #    #
#############