##############
# .   .   .  #
# $ # $ # $  #
#   #   #    #
# @   .   $  #
##############