#############
# . #   .   #
# $ # $ $   #
#   @       #
#############