###################
#   #########     #
# . #       #     #
# $ $$ $$ $ #     #
# $$   .    #     #
#    @      #     #
###################