############
#  .   .   #
# $$#$$    #
#   @      #
############