###################
# . . . . . . .   #
# $$$$$$$$$$$     #
#       @         #
###################