###############
# .   .   .   #
# $ # $ # $   #
# ###   ###   #
# @ .   . $   #
#         $   #
###############