##########
#   .    #
# ###$   #
# @  .   #
#   $    #
#        #
##########