###########
# . . .   #
#   $$$   #
#    @    #
###########