######################
#      ##########    #
# .$$$ #        #    #
# $$$  # $$$ $$ #    #
#  ... #  ..    #    #
#     @         #    #
######################