##########
# .   .  #
# $   $  #
#   @    #
##########