################
# . .# . . .   #
# $$# $$# $    #
#      @       #
################