##############
# . . . .    #
# $$$$ $$$   #
#     @      #
##############