###########
# .   .   #
# $ # $   #
#   #     #
# @   .   #
#     $   #
###########