##################
# .  .  .  .  .  #
# $$$ $$$ $$$    #
#       @        #
##################